####################
#                  #
#    ###     ###   #
#    #        #    #
#    #        #    #
#    #        #    #
#    #        #    #
#    #        #    #
#    ###     ###   #
#                  #
#                  #
#                  #
#                  #
####################


