#############
#***F*******#
#***********#
#***********#
#***********#
#***********#
#***********#
#******F****#
#***********#
#********#**#
#*F******#**#
#********#**#
#********#**#
#********#**#
#############
