#############
#***F*******#
#***********#
#***###*****#
#***********#
#***********#
#***###*****#
#**F********#
#*********F*#
#***###*****#
#***********#
#***********#
#***###*****#
#***********#
#############
