#############
#***f*******#
#***********#
#***********#
#***********#
#***********#
#***********#
#***********#
#***********#
#***********#
#***********#
#***********#
#***********#
#***********#
#############
